11111111111111111111111111111111111111111111111111
10000000000000000000000000000000000000000000000001
10000000000000000000000000000000000000000000000001
10000000000000000000000000000000000000000000000001
10000000000000000000000000000000000000000000000001
10000000000000000000000000000000000000000000000001
10000111111111111111111111111111111111111111111111
10000100000000000000000000000000000000000000010001
100001000000DDDD00000000000000000000000000000000E1
100001000000DDDD0000000000000000000000000000010001
10000100000000111111111111111111111111111111111111
10000100000000100000000000000000000000000000000001
10000100000000100000000000000000000000000000000001
10000100000000100000000000000000000000000000000001
10000100000000100000000000000000000000000000000001
10000100000000100000000000000000000000000000000001
10000100000000100000000000000000000000000000000001
10000100000000100000000000000000000000000000000001
1000010M0M0000100000000000000000000000000000000001
10000100000000100000000000000000000000000000000001
10000100M00000100000000000000000000000000000000001
10000101111111100000000000000000000000000000000001
100001P1000000000000000000000000000000000000000001
10000111000000000000000000000000000000000000000001
11111111111111111111111111111111111111111111111111
